3 3 3 3 3 3 3 3
2 P 2 0 0 2 S 2
2 2 2 B S 2 2 2
3 3 3 0 0 3 3 3
1 1 1 B B 1 1 1
1 1 0 0 0 0 1 1
1 0 0 0 0 0 0 1