3 3 3 3 3 3 3 3
3 3 3 B S 3 3 3
2 2 2 0 0 2 2 2
2 2 0 0 0 0 2 2
1 0 0 0 0 0 0 B
